###############################################################################
#                  #             ####################                         #
#  ##############     ##########          C##########  #  #######   ###   #   #
#            #     #            #####################  #     ####     #   #   #
# ###    ##  #  ###################    ##        ####### ##############   #   #
#######      #  ####                   #   #    ## #  #                   #   #
######### #             ### ## #      ## ###                 #   ###########  #
#   #        #########                   #        #   #       ####            #
### ##########            ###       #################   ####  ##   #####  #####
#     ########  ####  #####    ######    ##        ##    #    #### #          #
#  ##      ####           #                   ##    ######    ##############  #
#  #                ######################## ##               ###########  #  #
#  # #############  #   #   #   #        #    # ###############         #  #  #
#  #  #####           #   #   #   # # ###### # #####              ##### #  #  #
#             ###     ############# # #    # # #####  ################# #  #  #
###################                 # ###### # #####                  # # ##  #
#                 ###  ##############        #    ####     #####    # # #     #
####### ####### # ##                ############# # ##           # ## # # #####
#     #         #  #   ######### ####    #     ## #  #  ######     ## # #     #
# # # ### ##### ## #                #    #   # ###  ##       ########   ##### #
### ########### #       #################  ###   # #  ######     #   #        #
#     ######    #########                  ###     ##         ##   #      S   #
#####        ##           ############      ###          ##      #   #        #
###############################################################################