#C################
#       ## ##    # 
# # ## #####  # ## 
###        #### ##
######### ###S  ##
##  ##    #### ###
#   ####         #
##################                                                                                                                                                                                       