###c#######################
#    ####   ###  #      ###
# ######### ####   #### ###
# #     #   ###### ####   #
#   ### # # ###### ########
#######   ########    S####
#########          ########
###########################